NO xpm/wall_1.xpm
SO xpm/wall_2.xpm
WE xpm/wall_3.xpm
EA xpm/wall_4.xpm

F 140,82,31
C 38,109,211

        1111111111111111111111111
        1000000000110000000000001
        1011000001110000000000001
        1001000000000000000000001
111111111011000001110000000000001
100000000011000001110111111111111
11110111111111011100000010001
11110111111111011101010010001
11000000110101011100101010001
10000000000000001100010000001
10000000000000001101010010001
10000001110101011111011110001
10110111 1110101 101111010001
10111111 1111111 111111111111
101
101
1001
10001111111111111
10000000000000001
10000011111110001
10000011001111001
100000000001S1101
10001111111111001
11111        1111