NO xpm/path_to_the_north_texture.xpm
SO xpm/path_to_the_south_texture.xpm
WE xpm/path_to_the_west_texture.xpm
EA xpm/path_to_the_east_texture.xpm

F 220,100,0
C 225,0,2

1111111111111111111111111
1000000000110000000000001
1011000001110000000000001
100100000000000000000000111111111
111111111011000001110000000000001
100000000011000001110111111111111
11110111111111011100000010001
11110111111111011101010010001
11000000110101011100000010001
10000000000000001100000010001
10000000000000001101010010001
11000001110101011111011110N01
11110111 1110101 101111010001
11111111 1111111 111111111111

111
1001
10001111111111111
10000000000000001
10000011111110001
10000011001111001
10000000000111101
10001111111111001
11111        1111