NO xpm/wall_1.xpm
SO xpm/wall_2.xpm
WE xpm/wall_3.xpm
EA xpm/wall_4.xpm

F 220,100,0
C 106,12,253

        1111111111111111111111111
        1000000000110000000000001
        1011000001110000000000001
        1001000000000000000000001
111111111011000001110000000000001
100000000011000001110111111111111
11110111111111011100000010001
11110111111111011101010010001
110000001101010111001N1010001
10000000000000001100010010001
10000000000000001101010010001
11000001110101011111011110001
11110111 1110101 101111010001
11111111 1111111 111111111111

111
1001
10001111111111111
10000000000000001
10000011111110001
10000011001111001
10000000000111101
10001111111111001
11111        1111
