NO ./path_to_the_north_texture
SO ./path_to_the_south_texture
WE ./path_to_the_west_texture
EA ./path_to_the_east_texture

F 220,100,0
C 225,30,0

1111111111111111111111111
1000000000110000000000001
1011000001110000000000001
100100000000000000000000133333333
111111111011000001110000000000001
100000000011000001110111111111111
111101111111110111000000100013333
111101111111110111010100100013333
110000001101010111000000100013333
10000000000000001100000010001
10000000000000001101010010001
11000001110101011111011110N0111
11110111311101013101111010001
111111113111111131111111111113333
